............
........0...
.....0......
.......0....
....0.......
......A....D
...........D
............
........A...
.........A..
............
............