...........A
........B...
.....B......
.......B....
....B.......
......A.....
.....U......
............
........A...
.........A..
............
A...........